2 3
1111111
1000001
1110001
1100001
1110001
1000001
1111111