22 2
1111111111111111111111111
1000000000000000000000001
1000111111111111111110001
1000100000000000000000001
1000101111111111111110001
1000101000000000000000001
1000101111111111111110001
1000100000000000000000001
1000100000000000000000001
1000111111111111111110001
1000000000000000000000001
1000000000000000000000001
1000000000000000000000001
1000000000000000000000001
1111111111111111111111111
