18 9
11111111111111111111111
10000000000000000000001
10000000000000000000001
10000000000000000000001
10000111111111111000001
10000100000000001000001
10000100000000001000001
10000000000000000000001
10000101111100001000001
10000101000100001000001
10000101111100001000001
10000000000000000000001
10000000000000000000001
11111111111111111111111